1111101111
1111001111
1110001111
1100001111
1000001111
